1111111111111
1000000000C11
1000011111001
1P1C11E0CC001
1111111111111